##########
#....B...#
#.b##.##.#
#.dJ.....#
#....B#..#
##########