# # # # # # # # # #
# . . . d b . . . #
# . b # # . # # . #
# . d J . b . . . #
# . . . . d # . . #
# # # # # # # # # #
