##########
#........#
#J.......#
#b....bd.#
#d.......#
##########