#########
##...#..#
##b#....#
#.b..#..#
#.#d.d.##
#J..#...#
#####...#
#########