##########
###......#
#d..J....#
#####..b.#
#........#
##########
##########