##########
###......#
#dJJJ....#
#####....#
#........#
##########