##########
####.#####
#d..b.####
#dbJb..###
#d##....##
##########