##########
####...###
##.b.#.###
##.#..d.##
##.d..#.##
###b#db.##
###J..####
##########