##########
####d.####
####.bd.##
#...d.#.##
#.#J#.b.##
#...b..###
####..####
##########