##########
##..##..##
##J.#...##
#d.b#...##
#...b..###
#d.##..###
##########