#########
##..#...#
##db#...#
##.....##
#.db#..##
#.J.#..##
#..######
#########