#########
#...#####
#.#.B...#
#...##..#
#.J.#d.##
##..b..##
##..#..##
#########