##########
#...db...#
#.b##.##.#
#.dJ.b...#
#....d#..#
##########
