##########
###......#
#dJb.....#
#####....#
#........#
##########